0,0,1,1,1,1,1,1,1,1,1,1,1,1,1,1,1,1,1,1,1,1,1,1,1,1,1,1,1,1,1,1,1,1,1,1,1,1,1,1,1,1,1,1,1,1,1,1,1,1,1,1,1,1,1,1,1,1,1,1,1,1,1,1,1,1,1,1,1,1,1,1,1,1,1,1,1,1,1,1,1,1,1,1,1,1,1,1,1,1,1,1,1,1,1,1,1,1,1,1,1,1,1,1,1,1,1,1,1,1,1,1,1,1,1,1,1,1,1,1,1,1,1,1,1,1,1,1,1,1,1,1,1,1,1,1,1,1,1,1,1,1,1,1,1,1,1,1,1,1,1,1,1,1,1,1,1,1,1,1,1,1,1,1,1,1,1,1,1,1,1,1,1,1,1,1,1,1,1,1,1,1,1,1,1,1,1,1,1,1,1,1,1,1,1,1,1,1,1,1,1,1,1,1,1,1,1,1,1,1,1,1,1,1,1,1,1,1,1,1,1,1,1,1,1,1,1,1,1,1,1,1,1,1,1,1,1,1,1,1,1,1,1,1,1,1,1,1,1,1,1,1,1,1,1,1,1,1,1,1,1,1,1,1,1,1,1,1,1,1,1,1,1,1,1,1,1,1,1,1,1,1,1,1,1,1,1,1,1,1,1,1,1,1,1,1,1,1,1,1,1,1,1,1,1,1,1,1,1,1,1,1,1,1,1,1,1,1,1,1,1,1,1,1,1,1,1,1,1,1,1,1,1,1,1,1,1,1,1,1,1,1,1,1,1,1,1,1,1,1,1,1,1,1,1,1,1,1,1,1,1,1,1,1,1,1,1,1,1,1,1,1,1,1,1,1,1,1,1,1,1,1,1,1,1,1,1,1,1,1,1,1,1,1,1,1,1,1,1,1,1,1,1,1,1,1,1,1,1,1,1,1,1,1,1,1,1,1,1,1,1,1,1,1,1,1,1,1,1,1,1,1,1,1,1,1,1,1,1,1,1,1,1,1,1,1,1,1,1,1,1,1,1,1,1,1,1,1,1,1,1,1,1,1,1,1,1,1,1,1,1,1,1,1,1,1,1,1,1,1,1,1,1,1,1,1,1,1,1,1,1,1,1,1,1,1,1,1,1,1,1,1,0,0,0,0,0,1,1,1,1,1,
0,0,1,1,1,1,1,1,1,1,1,1,1,1,1,1,1,1,1,1,1,1,1,1,1,1,1,1,1,1,1,1,1,1,1,1,1,1,1,1,1,1,1,1,1,1,1,1,1,1,1,1,1,1,1,1,1,1,1,1,1,1,1,1,1,1,1,1,1,1,1,1,1,1,1,1,1,1,1,1,1,1,1,1,1,1,1,1,1,1,1,1,1,1,1,1,1,1,1,1,1,1,1,1,1,1,1,1,1,1,1,1,1,1,1,1,1,1,1,1,1,1,1,1,1,1,1,1,1,1,1,1,1,1,1,1,1,1,1,1,1,1,1,1,1,1,1,1,1,1,1,1,1,1,1,1,1,1,1,1,1,1,1,1,1,1,1,1,1,1,1,1,1,1,1,1,1,1,1,1,1,1,1,1,1,1,1,1,1,1,1,1,1,1,1,1,1,1,1,1,1,1,1,1,1,1,1,1,1,1,1,1,1,1,1,1,1,1,1,1,1,1,1,1,1,1,1,1,1,1,1,1,1,1,1,1,1,1,1,1,1,1,1,1,1,1,1,1,1,1,1,1,1,1,1,1,1,1,1,1,1,1,1,1,1,1,1,1,1,1,1,1,1,1,1,1,1,1,1,1,1,1,1,1,1,1,1,1,1,1,1,1,1,1,1,1,1,1,1,1,1,1,1,1,1,1,1,1,1,1,1,1,1,1,1,1,1,1,1,1,1,1,1,1,1,1,1,1,1,1,1,1,1,1,1,1,1,1,1,1,1,1,1,1,1,1,1,1,1,1,1,1,1,1,1,1,1,1,1,1,1,1,1,1,1,1,1,1,1,1,1,1,1,1,1,1,1,1,1,1,1,1,1,1,1,1,1,1,1,1,1,1,1,1,1,1,1,1,1,1,1,1,1,1,1,1,1,1,1,1,1,1,1,1,1,1,1,1,1,1,1,1,1,1,1,1,1,1,1,1,1,1,1,1,1,1,1,1,1,1,1,1,1,1,1,1,1,1,1,1,1,1,1,1,1,1,1,1,1,1,1,1,1,1,1,1,1,1,1,1,1,1,1,1,1,1,1,1,1,1,1,1,1,1,1,1,1,1,1,1,1,1,1,1,1,1,1,1,1,1,1,1,0,0,0,0,2,3,4,3,4,3,
0,0,1,1,1,1,1,1,1,1,1,1,1,1,1,1,1,1,1,1,1,1,1,1,1,1,1,1,1,1,1,1,1,1,1,1,1,1,1,1,1,1,1,1,1,1,1,1,1,1,1,1,1,1,1,1,1,1,1,1,1,1,1,1,1,1,1,1,1,1,1,1,1,1,1,1,1,1,1,1,1,1,1,1,1,1,1,1,1,1,1,1,1,1,1,1,1,1,1,1,1,1,1,1,1,1,1,1,1,1,1,1,1,1,1,1,1,1,1,1,1,1,1,1,1,1,1,1,1,1,1,1,1,1,1,1,1,1,1,1,1,1,1,1,1,1,1,1,1,1,1,1,1,1,1,1,1,1,1,1,1,1,1,1,1,1,1,1,1,1,1,1,1,1,1,1,1,1,1,1,1,1,1,1,1,1,1,1,1,1,1,1,1,1,1,1,1,1,1,1,1,1,1,1,1,1,1,1,1,1,1,1,1,1,1,1,1,1,1,1,1,1,1,1,1,1,1,1,1,1,1,1,1,1,1,1,1,1,1,1,1,1,1,1,1,1,1,1,1,1,1,1,1,1,1,1,1,1,1,1,1,1,1,1,1,1,1,1,1,1,1,1,1,1,1,1,1,1,1,1,1,1,1,1,1,1,1,1,1,1,1,1,1,1,1,1,1,1,1,1,1,1,1,1,1,1,1,1,1,1,1,1,1,1,1,1,1,1,1,1,1,1,1,1,1,1,1,1,1,1,1,1,1,1,1,1,1,1,1,1,1,1,1,1,1,1,1,1,1,1,1,1,1,1,1,1,1,1,1,1,1,1,1,1,1,1,1,1,1,1,1,1,1,1,1,1,1,1,1,1,1,1,1,1,1,1,1,1,1,1,1,1,1,1,1,1,1,1,1,1,1,1,1,1,1,1,1,1,1,1,1,1,1,1,1,1,1,1,1,1,1,1,1,1,1,1,1,1,1,1,1,1,1,1,1,1,1,1,1,1,1,1,1,1,1,1,1,1,1,1,1,1,1,1,1,1,1,1,1,1,1,1,1,1,1,1,1,1,1,1,1,1,1,1,1,1,1,1,1,1,1,1,1,1,1,1,1,1,1,1,1,1,1,1,1,1,1,1,1,1,1,1,0,0,0,5,6,7,8,7,8,7,
0,0,1,1,1,1,1,1,1,1,1,1,9,10,1,1,1,1,1,1,1,1,1,1,1,1,1,1,9,10,1,1,1,1,1,1,1,1,1,1,1,1,1,1,9,10,1,1,1,1,1,1,1,1,1,1,1,1,1,1,9,10,1,1,1,1,1,1,1,1,1,1,1,1,1,1,1,1,1,1,1,1,1,1,1,1,1,1,1,1,1,1,9,10,1,1,1,1,1,1,1,1,1,1,1,1,1,1,9,10,1,1,1,1,1,1,1,1,1,1,1,1,1,1,1,1,1,1,1,1,1,1,1,1,1,1,1,1,1,1,1,1,1,1,1,1,1,1,9,10,1,1,1,1,1,1,1,1,1,1,1,1,1,1,9,10,1,1,1,1,1,1,1,1,1,1,1,1,1,1,9,10,1,1,1,1,1,1,1,1,1,1,1,1,1,1,9,10,1,1,1,1,1,1,1,1,1,1,1,1,1,1,9,10,1,1,1,1,1,1,1,1,1,1,1,1,1,1,9,10,1,1,1,1,1,1,1,1,1,1,1,1,1,1,1,1,1,1,1,1,1,11,12,13,1,1,1,1,1,1,1,1,1,1,1,1,1,1,1,1,1,1,1,1,1,1,1,1,1,1,1,1,1,1,1,1,1,1,1,1,1,1,1,1,1,1,1,1,1,1,1,1,1,1,1,1,1,1,1,1,1,1,1,1,1,11,12,13,1,1,1,1,1,11,12,13,1,1,1,1,1,1,1,1,1,1,1,1,1,1,9,10,1,1,1,1,1,1,1,1,1,1,1,1,1,1,9,10,1,1,1,1,1,1,1,1,1,1,1,1,1,1,9,10,1,1,1,1,1,1,1,1,1,1,1,1,1,11,12,13,1,1,1,1,1,1,1,1,1,1,1,1,1,1,9,10,1,1,1,1,1,1,1,1,1,1,1,1,1,1,9,10,1,1,1,1,1,1,1,1,1,1,1,1,1,1,9,10,1,1,1,1,1,1,1,1,1,1,1,1,1,1,9,10,1,1,1,1,1,1,1,1,1,1,1,1,1,1,9,10,1,1,1,1,1,1,1,1,1,1,1,1,1,1,9,10,1,1,1,1,1,1,1,1,1,1,1,1,1,1,1,1,0,0,0,14,15,16,17,16,17,16,
0,0,18,18,1,1,1,1,1,1,1,1,19,20,1,1,1,1,1,1,1,1,1,1,1,1,1,1,19,20,1,1,1,1,21,22,23,1,1,1,1,1,1,1,19,20,1,1,1,1,21,22,23,1,1,1,1,1,1,1,19,20,1,1,1,1,21,22,23,1,1,1,1,1,1,1,1,1,1,1,1,1,1,1,1,1,1,1,1,1,1,1,19,20,1,1,1,1,21,22,23,1,1,1,1,1,1,1,19,20,1,1,1,1,21,22,23,1,1,1,1,1,1,1,1,1,1,1,1,1,1,1,1,1,1,1,1,1,21,22,23,1,1,1,1,1,1,1,19,20,1,1,1,1,21,22,23,1,1,1,1,1,1,1,19,20,1,1,1,1,21,22,23,1,1,1,1,1,1,1,19,20,1,1,1,1,21,22,23,1,1,1,1,1,1,1,19,20,1,1,1,1,21,22,23,1,1,1,1,1,1,1,19,20,1,1,1,1,21,22,23,1,1,1,1,1,1,1,19,20,1,1,1,1,1,1,1,1,1,1,1,1,1,1,1,1,1,1,1,1,24,25,26,27,28,1,1,1,1,1,1,1,1,1,1,1,1,1,1,1,1,1,1,1,21,22,23,1,1,1,1,1,1,1,1,1,1,1,1,1,1,1,1,1,1,1,1,1,1,1,1,1,1,1,1,1,1,1,1,1,1,1,1,1,24,25,26,27,28,1,1,1,24,25,26,27,28,1,1,1,1,1,1,1,1,1,1,1,1,1,19,20,1,1,1,1,21,22,23,1,1,1,1,1,1,1,19,20,1,1,1,1,1,1,1,1,1,1,1,1,1,1,19,20,1,1,1,1,1,1,1,1,1,1,1,1,24,25,26,27,28,1,1,1,1,1,1,1,1,1,1,1,1,1,19,20,1,1,1,1,21,22,23,1,1,1,1,1,1,1,19,20,1,1,1,1,21,22,23,1,1,1,1,1,1,1,19,20,1,1,1,1,21,22,23,1,1,1,1,1,1,1,19,20,1,1,1,1,21,22,23,1,1,1,1,1,1,1,19,20,1,1,1,1,21,22,23,1,1,1,1,1,1,1,19,20,1,1,1,1,21,22,23,1,1,1,1,1,1,1,1,1,0,0,0,29,30,31,32,33,34,35,
36,37,36,37,38,39,40,41,1,1,1,1,1,1,1,1,1,1,1,1,1,1,1,1,1,1,1,1,1,1,1,1,1,1,42,43,44,45,1,1,1,1,1,1,1,1,1,1,1,1,42,43,44,45,1,1,1,1,1,1,1,1,1,1,1,1,42,43,44,45,1,1,1,1,1,1,1,1,1,1,1,1,1,1,1,1,1,1,1,1,1,1,1,1,1,1,1,1,42,43,44,45,1,1,1,1,1,1,1,1,1,1,1,1,42,43,44,45,1,1,1,1,1,1,1,1,1,1,1,1,1,1,1,1,1,1,1,1,42,43,44,45,1,1,1,1,1,1,1,1,1,1,1,1,42,43,44,45,1,1,1,1,1,1,1,1,1,1,1,1,42,43,44,45,1,1,1,1,1,1,1,1,1,1,1,1,42,43,44,45,1,1,1,1,1,1,1,1,1,1,1,1,42,43,44,45,1,1,1,1,1,1,1,1,1,1,1,1,42,43,44,45,1,1,1,1,1,1,1,1,1,1,1,1,1,1,1,1,1,1,1,1,1,1,1,1,1,1,1,1,46,47,48,49,1,1,1,1,1,1,1,1,1,1,1,1,1,1,1,1,1,1,1,1,42,43,44,45,1,1,1,1,1,1,1,1,1,1,1,1,1,1,1,1,1,1,1,1,1,1,1,1,1,1,1,1,1,1,1,1,1,1,1,1,46,47,48,49,1,1,1,1,46,47,48,49,1,1,1,1,1,1,1,1,1,1,1,1,1,1,1,1,1,1,1,1,42,43,44,45,1,1,1,1,1,1,1,1,1,1,1,1,1,1,1,1,1,1,1,1,1,1,1,1,1,1,1,1,1,1,1,1,1,1,1,1,46,47,48,49,1,1,1,1,1,1,1,1,1,1,1,1,1,1,1,1,1,1,1,1,42,43,44,45,1,1,1,1,1,1,1,1,1,1,1,1,42,43,44,45,1,1,1,1,1,1,1,1,1,1,1,1,42,43,44,45,1,1,1,1,1,1,1,1,1,1,1,1,42,43,44,45,1,1,1,1,1,1,1,1,1,1,1,1,42,43,44,45,1,1,1,1,1,1,1,1,1,1,1,1,42,43,44,45,1,1,1,1,1,1,1,1,0,0,5,50,51,52,53,54,55,56,
57,58,59,60,59,60,61,62,1,1,1,1,1,1,1,1,1,1,1,1,1,1,1,1,1,1,1,1,1,1,1,1,1,1,1,1,1,1,1,1,1,1,1,1,1,1,1,1,1,1,1,1,1,1,1,1,1,1,1,1,1,1,1,1,1,1,1,1,1,1,1,1,1,1,1,1,1,1,1,1,1,1,1,1,1,1,1,1,1,1,1,1,1,1,1,1,1,1,1,1,1,1,1,1,1,1,1,1,1,1,1,1,1,1,1,1,1,1,1,1,1,1,1,1,1,1,1,1,1,1,1,1,1,1,1,1,1,1,1,1,1,1,1,1,1,1,1,1,1,1,1,1,1,1,1,1,1,1,1,1,1,1,1,1,1,1,1,1,1,1,1,1,1,1,1,1,1,1,1,1,1,1,1,1,1,1,1,1,1,1,1,1,1,1,1,1,1,1,1,1,1,1,1,1,1,1,1,1,1,1,1,1,1,1,1,1,1,1,1,1,1,1,1,1,1,1,1,1,1,1,1,1,1,1,1,1,1,1,1,1,1,1,1,1,1,1,1,1,1,1,1,63,64,1,1,1,1,1,1,1,1,1,1,1,1,1,1,1,1,1,1,1,1,1,1,1,1,1,1,1,1,1,1,1,1,1,1,1,1,1,1,1,1,1,1,1,1,1,1,1,1,1,1,1,1,1,1,1,1,1,1,1,1,1,1,63,64,1,1,1,1,1,1,63,64,1,1,1,1,1,1,1,1,1,1,1,1,1,1,1,1,1,1,1,1,1,1,1,1,1,1,1,1,1,1,1,1,1,1,1,1,1,1,1,1,1,1,1,1,1,1,1,1,1,1,1,1,1,1,1,1,1,1,1,1,1,1,63,64,1,1,1,1,1,1,1,1,1,1,1,1,1,1,1,1,1,1,1,1,1,1,1,1,1,1,1,1,1,1,1,1,1,1,1,1,1,1,1,1,1,1,1,1,1,1,1,1,1,1,1,1,1,1,1,1,1,1,1,1,1,1,1,1,1,1,1,1,1,1,1,1,1,1,1,1,1,1,1,1,1,1,1,1,1,1,1,1,1,1,1,1,1,1,1,1,1,1,1,1,1,1,1,1,1,1,1,1,1,1,1,1,1,0,0,65,66,67,68,69,69,70,7,
71,72,73,74,75,76,1,1,1,1,1,1,1,1,1,1,1,1,1,1,1,1,1,1,1,1,1,1,1,1,1,1,1,1,1,1,1,1,1,1,1,1,1,1,1,1,1,1,1,1,1,1,1,1,1,1,1,1,1,1,1,1,1,1,1,1,1,1,1,1,1,1,1,1,1,1,1,1,1,1,1,1,1,1,1,1,1,1,1,1,1,1,1,1,1,1,1,1,1,1,1,1,1,1,1,1,1,1,1,1,1,1,1,1,1,1,1,1,1,1,1,1,1,1,1,1,1,1,1,1,1,1,1,1,1,1,1,1,1,1,1,1,1,1,1,1,1,1,1,1,1,1,1,1,1,1,1,1,1,1,1,1,1,1,1,1,1,1,1,1,1,1,1,1,1,1,1,1,1,1,1,1,1,1,1,1,1,1,1,1,1,1,1,1,1,1,1,1,1,1,1,1,1,1,1,1,1,1,1,1,1,1,1,1,1,1,1,1,1,1,1,1,1,1,1,1,1,1,1,1,1,1,1,1,1,1,1,1,1,1,1,1,1,1,1,1,1,1,1,1,1,63,64,1,1,1,1,1,1,1,1,1,1,1,1,1,1,1,1,1,1,1,1,1,1,1,1,1,1,1,1,1,1,1,1,1,1,1,1,1,1,1,1,1,1,1,1,1,1,1,1,1,1,1,1,1,1,1,1,1,1,1,1,1,1,63,64,1,1,1,1,1,1,63,64,1,1,1,1,1,1,1,1,1,1,1,1,1,1,1,1,1,1,1,1,1,1,1,1,1,1,1,1,1,1,1,1,1,1,1,1,1,1,1,1,1,1,1,1,1,1,1,1,1,1,1,1,1,1,1,1,1,1,1,1,1,1,63,64,1,1,1,1,1,1,1,1,1,1,1,1,1,1,1,1,1,1,1,1,1,1,1,1,1,1,1,1,1,1,1,1,1,1,1,1,1,1,1,1,1,1,1,1,1,1,1,1,1,1,1,1,1,1,1,1,1,1,1,1,1,1,1,1,1,1,1,1,1,1,1,1,1,1,1,1,1,1,1,1,1,1,1,1,1,1,1,1,1,1,1,1,1,1,1,1,1,1,1,1,1,1,1,1,1,1,1,1,1,1,1,1,1,0,0,77,78,15,79,80,80,81,16,
57,58,59,60,82,1,1,1,1,1,1,1,1,1,1,1,1,1,1,1,1,1,1,1,1,1,1,1,1,1,1,1,1,1,1,1,1,1,1,1,1,1,1,1,1,1,1,1,1,1,1,1,1,1,1,1,1,1,1,1,1,1,1,1,1,1,1,1,1,1,1,1,1,1,1,1,1,1,1,1,1,1,1,1,1,1,1,1,1,1,1,1,1,1,1,1,1,1,1,1,1,1,1,1,1,1,1,1,1,1,1,1,1,1,1,1,1,1,1,1,1,1,1,1,1,1,1,1,1,1,1,1,1,1,1,1,1,1,1,1,1,1,1,1,1,1,1,1,1,1,1,1,1,1,1,1,1,1,1,1,1,1,1,1,1,1,1,1,1,1,1,1,1,1,1,1,1,1,1,1,1,1,1,1,1,1,1,1,1,1,1,1,1,1,1,1,1,1,1,1,1,1,1,1,1,1,1,1,1,1,1,1,1,1,1,1,1,1,1,1,1,1,1,1,1,1,1,1,1,1,1,1,1,1,1,1,1,1,1,1,1,1,1,1,1,1,1,1,1,1,1,83,64,1,1,1,1,1,1,1,1,1,1,1,1,1,1,1,1,1,1,1,1,1,1,1,1,1,1,1,1,1,1,1,1,1,1,1,1,1,1,1,1,1,1,1,1,1,1,1,1,1,1,1,1,1,1,1,1,1,1,1,1,1,1,83,64,1,1,1,1,1,1,83,64,1,1,1,1,1,1,1,1,1,1,1,1,1,1,1,1,1,1,1,1,1,1,1,1,1,1,1,1,1,1,1,1,1,1,1,1,1,1,1,1,1,1,1,1,1,1,1,1,1,1,1,1,1,1,1,1,1,1,1,1,1,1,83,64,1,1,1,1,1,1,1,1,1,1,1,1,1,1,1,1,1,1,1,1,1,1,1,1,1,1,1,1,1,1,1,1,1,1,1,1,1,1,1,1,1,1,1,1,1,1,1,1,1,1,1,1,1,1,1,1,1,1,1,1,1,1,1,1,1,1,1,1,1,1,1,1,1,1,1,1,1,1,1,1,1,1,1,1,1,1,1,1,1,1,1,1,1,1,1,1,1,1,1,1,1,1,1,1,1,1,1,1,1,1,1,1,1,0,0,84,66,67,85,80,80,86,7,
71,72,73,74,87,1,1,1,1,1,1,1,1,1,1,1,88,89,90,89,90,89,90,91,1,1,1,1,1,1,1,1,1,1,1,1,1,1,1,1,1,1,1,1,1,1,1,1,1,1,1,1,1,1,1,1,1,1,1,1,1,1,1,1,1,1,1,1,1,1,1,1,88,89,90,89,90,89,90,89,90,89,90,89,90,89,90,91,1,1,1,1,1,1,1,1,1,1,1,1,1,1,1,1,1,1,1,1,1,1,1,1,1,1,1,1,1,1,1,1,1,1,1,1,88,89,90,89,90,89,90,89,90,89,90,91,1,1,1,1,1,1,1,1,1,1,1,1,1,1,1,1,1,1,1,1,1,1,1,1,1,1,1,1,1,1,1,1,1,1,1,1,1,1,1,1,1,1,1,1,1,1,1,1,1,1,1,1,1,1,1,1,1,1,1,1,1,1,1,1,1,1,1,1,1,1,1,1,1,1,1,1,1,1,1,1,1,1,1,1,1,1,1,1,1,1,1,1,1,1,1,1,1,1,1,1,88,89,90,89,90,89,90,89,90,89,90,89,90,89,90,92,93,89,90,89,90,89,90,89,90,89,90,89,90,89,90,89,90,89,90,91,1,1,1,1,1,1,1,1,88,89,90,89,90,89,90,89,90,89,90,89,90,89,90,89,90,89,90,89,90,89,90,89,90,89,90,89,90,89,90,89,90,89,90,92,93,89,90,89,90,89,90,92,93,89,90,89,90,89,90,89,90,89,90,91,1,1,1,1,1,1,1,1,1,1,1,1,1,1,1,1,1,1,1,1,1,1,1,1,1,1,1,1,1,1,1,1,1,1,1,1,1,1,1,1,88,89,90,89,90,89,90,89,90,89,90,92,93,89,90,89,90,89,90,89,90,89,90,91,1,1,1,1,1,1,1,1,1,1,1,1,1,1,1,1,1,1,1,1,1,1,1,1,1,1,1,1,1,1,1,1,1,1,1,1,1,1,1,1,1,1,1,1,1,1,1,1,1,1,1,1,1,1,1,1,1,1,1,1,1,1,1,1,1,1,1,1,1,1,1,1,1,1,1,1,1,1,1,1,1,1,1,1,1,1,1,1,1,1,1,1,1,1,1,1,88,89,90,89,90,89,94,95,96,97,98,99,100,101,102,103,
57,58,59,60,104,1,1,1,1,1,1,1,1,1,1,1,105,106,107,106,107,106,107,108,1,1,1,1,1,1,1,1,1,1,1,1,1,1,1,1,1,1,1,1,1,1,1,1,1,1,1,1,1,1,1,1,1,1,1,1,1,1,1,1,1,1,1,1,1,1,1,1,105,106,107,106,107,106,107,106,107,106,107,106,107,106,107,108,1,1,1,1,1,1,1,1,1,1,1,1,1,1,1,1,1,1,1,1,1,1,1,1,1,1,1,1,1,1,1,1,1,1,1,1,105,106,107,106,107,106,107,106,107,106,107,108,1,1,1,1,1,1,1,1,1,1,1,1,1,1,1,1,1,1,1,1,1,1,1,1,1,1,1,1,1,1,1,1,1,1,1,1,1,1,1,1,1,1,1,1,1,1,1,1,1,1,1,1,1,1,1,1,1,1,1,1,1,1,1,1,1,1,1,1,1,1,1,1,1,1,1,1,1,1,1,1,1,1,1,1,1,1,1,1,1,1,1,1,1,1,1,1,1,1,1,1,105,106,107,106,107,106,107,106,107,106,107,106,107,106,107,106,107,106,107,106,107,106,107,106,107,106,107,106,107,106,107,106,107,106,107,108,1,1,1,1,1,1,1,1,105,106,107,106,107,106,107,106,107,106,107,106,107,106,107,106,107,106,107,106,107,106,107,106,107,106,107,106,107,106,107,106,107,106,107,106,107,106,107,106,107,106,107,106,107,106,107,106,107,106,107,106,107,106,107,108,1,1,1,1,1,1,1,1,1,1,1,1,1,1,1,1,1,1,1,1,1,1,1,1,1,1,1,1,1,1,1,1,1,1,1,1,1,1,1,1,105,106,107,106,107,106,107,106,107,106,107,106,107,106,107,106,107,106,107,106,107,106,107,108,1,1,1,1,1,1,1,1,1,1,1,1,1,1,1,1,1,1,1,1,1,1,1,1,1,1,1,1,1,1,1,1,1,1,1,1,1,1,1,1,1,1,1,1,1,1,1,1,1,1,1,1,1,1,1,1,1,1,1,1,1,1,1,1,1,1,1,1,1,1,1,1,1,1,1,1,1,1,1,1,1,1,1,1,1,1,1,1,1,1,1,1,1,1,1,1,105,106,107,106,107,106,109,110,109,110,109,106,107,106,107,106,
111,112,113,114,115,116,117,116,117,116,117,116,117,116,117,116,118,119,120,121,120,121,122,123,117,116,117,116,117,116,117,116,117,116,117,116,117,116,117,116,117,116,117,116,117,116,117,116,117,116,117,116,117,116,117,116,117,116,117,116,117,116,117,116,117,116,117,116,117,116,117,116,118,119,120,121,120,121,120,121,120,121,120,121,120,121,122,123,117,116,117,116,117,116,117,116,117,116,117,116,117,116,117,116,117,116,117,116,117,116,117,116,117,116,117,116,117,116,117,116,117,116,117,116,118,119,120,121,120,121,120,121,120,121,122,123,117,116,117,116,117,116,117,116,117,116,117,116,117,116,117,116,117,116,117,116,117,116,117,116,117,116,117,116,117,116,117,116,117,116,117,116,117,116,117,116,117,116,117,116,117,116,117,116,117,116,117,116,117,116,117,116,117,116,117,116,117,116,117,116,117,116,117,116,117,116,117,116,117,116,117,116,117,116,117,116,117,116,117,116,117,116,117,116,117,116,117,116,117,116,117,116,117,116,117,116,118,119,120,121,120,121,120,121,120,121,120,121,120,121,120,121,120,121,120,121,120,121,120,121,120,121,120,121,120,121,120,121,120,121,122,123,117,116,117,116,117,116,117,116,118,119,120,121,120,121,120,121,120,121,120,121,120,121,120,121,120,121,120,121,120,121,120,121,120,121,120,121,120,121,120,121,120,121,120,121,120,121,120,121,120,121,120,121,120,121,120,121,120,121,120,121,120,121,122,123,117,116,117,116,117,116,117,116,117,116,117,116,117,116,117,116,117,116,117,116,117,116,117,116,117,116,117,116,117,116,117,116,117,116,117,116,117,116,117,116,118,119,120,121,120,121,120,121,120,121,120,121,120,121,120,121,120,121,120,121,120,121,122,123,117,116,117,116,117,116,117,116,117,116,117,116,117,116,117,116,117,116,117,116,117,116,117,116,117,116,117,116,117,116,117,116,117,116,117,116,117,116,117,116,117,116,117,116,117,116,117,116,117,116,117,116,117,116,117,116,117,116,117,116,117,116,117,116,117,116,117,116,117,116,117,116,117,116,117,116,117,116,117,116,117,116,117,116,117,116,117,116,117,116,117,116,117,116,117,116,118,119,120,121,120,121,124,125,124,125,124,121,120,121,120,121,
126,127,126,127,128,129,128,129,128,129,128,129,128,129,128,129,128,129,126,127,126,127,128,129,128,129,128,129,128,129,128,129,128,129,128,129,128,129,128,129,128,129,128,129,128,129,128,129,128,129,128,129,128,129,128,129,128,129,128,129,128,129,128,129,128,129,128,129,128,129,128,129,128,129,126,127,126,127,126,127,126,127,126,127,126,127,128,129,128,129,128,129,128,129,128,129,128,129,128,129,128,129,128,129,128,129,128,129,128,129,128,129,128,129,128,129,128,129,128,129,128,129,128,129,128,129,126,127,126,127,126,127,126,127,128,129,128,129,128,129,128,129,128,129,128,129,128,129,128,129,128,129,128,129,128,129,128,129,128,129,128,129,128,129,128,129,128,129,128,129,128,129,128,129,128,129,128,129,128,129,128,129,128,129,128,129,128,129,128,129,128,129,128,129,128,129,128,129,128,129,128,129,128,129,128,129,128,129,128,129,128,129,128,129,128,129,128,129,128,129,128,129,128,129,128,129,128,129,128,129,128,129,128,129,128,129,128,129,126,127,126,127,126,127,126,127,126,127,126,127,126,127,126,127,126,127,126,127,126,127,126,127,126,127,126,127,126,127,126,127,128,129,128,129,128,129,128,129,128,129,128,129,126,127,126,127,126,127,126,127,126,127,126,127,126,127,126,127,126,127,126,127,126,127,126,127,126,127,126,127,126,127,126,127,126,127,126,127,126,127,126,127,126,127,126,127,126,127,126,127,126,127,126,127,128,129,128,129,128,129,128,129,128,129,128,129,128,129,128,129,128,129,128,129,128,129,128,129,128,129,128,129,128,129,128,129,128,129,128,129,128,129,128,129,128,129,128,129,126,127,126,127,126,127,126,127,126,127,126,127,126,127,126,127,126,127,126,127,128,129,128,129,128,129,128,129,128,129,128,129,128,129,128,129,128,129,128,129,128,129,128,129,128,129,128,129,128,129,128,129,128,129,128,129,128,129,128,129,128,129,128,129,128,129,128,129,128,129,128,129,128,129,128,129,128,129,128,129,128,129,128,129,128,129,128,129,128,129,128,129,128,129,128,129,128,129,128,129,128,129,128,129,128,129,128,129,128,129,128,129,128,129,128,129,128,129,128,129,126,127,126,127,130,131,130,131,130,127,126,127,126,127,
132,133,132,133,134,135,134,135,134,135,134,135,134,135,134,135,134,135,132,133,132,133,134,135,134,135,134,135,134,135,134,135,134,135,134,135,134,135,134,135,134,135,134,135,134,135,134,135,134,135,134,135,134,135,134,135,134,135,134,135,134,135,134,135,134,135,134,135,134,135,134,135,134,135,132,133,132,133,132,133,132,133,132,133,132,133,134,135,134,135,134,135,134,135,134,135,134,135,134,135,134,135,134,135,134,135,134,135,134,135,134,135,134,135,134,135,134,135,134,135,134,135,134,135,134,135,132,133,132,133,132,133,132,133,134,135,134,135,134,135,134,135,134,135,134,135,134,135,134,135,134,135,134,135,134,135,134,135,134,135,134,135,134,135,134,135,134,135,134,135,134,135,134,135,134,135,134,135,134,135,134,135,134,135,134,135,134,135,134,135,134,135,134,135,134,135,134,135,134,135,134,135,134,135,134,135,134,135,134,135,134,135,134,135,134,135,134,135,134,135,134,135,134,135,134,135,134,135,134,135,134,135,134,135,134,135,134,135,132,133,132,133,132,133,132,133,132,133,132,133,132,133,132,133,132,133,132,133,132,133,132,133,132,133,132,133,132,133,132,133,134,135,134,135,134,135,134,135,134,135,134,135,132,133,132,133,132,133,132,133,132,133,132,133,132,133,132,133,132,133,132,133,132,133,132,133,132,133,132,133,132,133,132,133,132,133,132,133,132,133,132,133,132,133,132,133,132,133,132,133,132,133,132,133,134,135,134,135,134,135,134,135,134,135,134,135,134,135,134,135,134,135,134,135,134,135,134,135,134,135,134,135,134,135,134,135,134,135,134,135,134,135,134,135,134,135,134,135,132,133,132,133,132,133,132,133,132,133,132,133,132,133,132,133,132,133,132,133,134,135,134,135,134,135,134,135,134,135,134,135,134,135,134,135,134,135,134,135,134,135,134,135,134,135,134,135,134,135,134,135,134,135,134,135,134,135,134,135,134,135,134,135,134,135,134,135,134,135,134,135,134,135,134,135,134,135,134,135,134,135,134,135,134,135,134,135,134,135,134,135,134,135,134,135,134,135,134,135,134,135,134,135,134,135,134,135,134,135,134,135,134,135,134,135,134,135,134,135,132,133,132,133,136,137,136,137,136,133,132,133,132,133